1 1 1 1 1 1 1 1 1
1 42 0 0 1 9 0 0 1
1 0 1 1 1 1 1 0 1
1 0 1 0 0 0 1 0 1
1 0 1 0 1 0 1 0 1
1 0 0 0 1 0 0 0 1
1 0 1 1 1 1 1 0 1
1 0 0 0 0 0 0 0 1
1 1 1 1 1 1 1 1 1
